098 098 098 098 098 098 098 098 044 098 098 098 098 098 044 098 
098 098 098 098 098 098 098 098 044 098 098 098 098 052 049 098 
098 098 098 098 098 098 098 098 044 045 098 098 098 048 051 098 
098 098 098 098 098 098 098 098 038 049 098 098 098 098 044 098 
098 098 098 098 098 122 120 120 130 120 126 033 123 098 044 098 
098 098 098 098 098 045 098 098 044 098 098 043 098 098 056 098 
098 098 098 098 098 044 098 098 044 098 098 043 098 098 044 098 
098 098 098 098 098 065 098 098 070 098 098 043 098 098 046 098 
098 098 118 120 120 129 120 120 129 120 126 060 125 120 120 121 
098 098 098 098 098 034 098 098 034 098 098 034 098 098 098 098 