056 098 098 098 044 098 098 098 098 098 098 098 098 098 098 098 
044 098 098 098 044 098 098 098 098 098 098 098 098 098 098 098 
046 098 098 098 044 098 098 098 051 098 098 098 098 098 098 098 
020 020 020 020 030 020 016 017 030 026 057 025 020 021 098 098 
098 098 098 098 044 098 098 098 044 098 044 098 098 045 098 098 
098 098 098 098 048 047 051 098 098 098 044 098 098 044 098 098 
098 098 098 098 098 098 044 098 098 098 044 098 098 044 098 098 
098 098 098 098 098 098 077 098 072 098 065 098 098 066 098 098 
098 098 118 126 058 125 129 120 129 120 129 120 120 128 121 098 
098 098 098 098 053 098 098 098 098 098 098 098 098 098 098 098 