098 098 044 098 098 098 098 098 098 098 098 098 098 098 098 098 
098 098 056 098 098 098 098 098 098 098 098 098 098 098 098 098 
098 098 044 098 098 098 098 098 098 098 098 098 098 098 098 098 
098 098 046 098 098 098 098 098 098 098 098 098 098 098 098 098 
098 022 020 020 020 020 020 020 026 057 025 020 020 021 098 098 
098 098 098 098 098 098 098 098 098 044 098 098 098 045 098 098 
098 098 098 098 098 098 098 098 098 044 098 098 098 044 098 098 
098 098 098 098 098 098 098 098 098 065 098 098 098 066 098 098 
098 098 118 120 120 126 058 125 120 129 120 120 120 128 120 021 
098 098 098 098 098 098 053 098 098 098 098 098 098 098 098 098 