098 098 098 098 052 049 098 098 098 052 098 098 098 098 098 098 
098 056 098 098 044 098 098 098 098 098 098 098 098 098 098 098 
098 048 035 020 020 026 058 025 020 030 028 028 021 098 098 098 
098 098 098 098 044 098 044 098 098 044 034 034 045 098 098 098 
047 051 098 098 046 098 044 098 098 071 034 034 066 098 098 098 
048 049 122 126 078 125 130 120 120 129 128 128 128 121 098 098 
098 098 045 098 098 098 044 098 098 098 098 098 098 098 098 098 
098 098 067 098 098 098 065 098 098 098 098 098 034 098 098 098 
098 022 028 020 020 020 029 020 020 020 020 020 028 018 098 098 
098 098 098 098 098 098 098 098 098 098 098 098 034 098 098 098 