098 056 098 098 044 098 098 098 098 098 098 098 098 098 098 098 
098 046 098 098 044 098 098 098 098 098 098 098 098 098 098 098 
022 020 020 020 030 020 026 058 025 026 058 025 020 020 021 098 
098 098 098 048 037 098 098 044 098 098 044 098 098 098 045 098 
098 098 098 098 070 098 098 044 098 098 065 098 098 098 066 098 
098 122 120 120 129 120 120 130 120 120 129 120 120 120 128 121 
098 045 098 098 098 098 098 044 098 098 098 098 098 098 098 098 
098 046 098 098 098 098 098 067 098 098 098 098 098 098 098 098 
022 020 020 020 020 020 020 029 020 026 058 025 020 018 098 098 
098 098 098 098 098 098 098 098 098 098 053 098 098 098 098 098 