098 098 098 098 098 098 098 098 098 098 098 098 098 098 056 098 
098 098 098 098 098 098 098 098 098 098 098 098 098 098 046 098 
098 098 122 120 120 126 057 125 120 126 057 125 120 120 120 121 
098 098 045 045 098 098 044 045 098 098 044 045 098 098 098 098 
098 098 038 049 098 098 038 049 098 098 038 049 098 098 098 098 
098 098 066 098 098 098 065 098 098 098 066 098 098 098 098 098 
098 022 028 020 020 020 029 020 020 020 029 026 057 025 036 051 
098 098 098 098 098 098 098 098 098 098 098 098 098 098 098 053 
098 098 098 098 098 098 098 098 098 098 098 022 020 018 098 048 
098 098 098 098 098 098 098 098 098 098 098 098 098 098 098 098 