098 044 098 098 098 051 098 044 098 044 098 098 098 098 098 098 
098 044 098 098 098 044 098 044 098 044 098 098 098 098 098 098 
098 044 098 098 034 044 098 044 098 044 098 098 098 098 098 098 
098 056 098 034 034 046 098 046 098 046 098 098 098 098 098 098 
098 046 098 034 034 070 098 077 098 078 098 098 098 098 098 098 
022 020 020 016 017 029 020 029 020 029 020 021 098 098 098 098 
098 044 098 098 098 098 098 098 098 098 098 045 098 098 098 098 
098 044 098 098 098 098 098 098 098 098 098 046 098 098 098 098 
098 048 098 098 098 098 098 098 098 098 022 020 020 018 098 098 
098 098 098 098 098 098 098 098 098 098 098 098 098 098 098 098 