098 098 098 056 098 098 098 098 044 044 098 098 098 098 098 098 
020 020 036 080 035 020 020 020 030 030 026 057 027 058 058 057 
098 098 098 098 098 098 098 098 078 071 098 098 098 040 040 040 
098 124 058 058 033 061 125 120 129 129 120 120 121 045 045 045 
098 040 040 040 098 098 098 098 098 098 098 098 098 048 050 049 
122 129 129 129 120 120 120 120 120 036 047 047 047 047 049 098 
045 098 098 098 098 098 098 098 098 098 098 098 098 098 098 098 
046 098 098 098 098 098 098 098 098 098 098 098 098 098 098 098 
020 020 020 020 020 020 026 058 027 058 025 020 020 018 098 098 
098 098 098 098 098 098 098 055 098 053 098 098 098 098 098 098 