098 098 098 098 098 098 098 098 098 098 098 098 098 098 044 098 
098 098 098 098 098 098 098 098 098 098 098 098 098 098 044 098 
098 098 098 098 122 120 126 057 125 120 126 033 123 098 056 098 
098 098 098 098 045 098 098 044 098 098 098 043 098 098 046 098 
126 057 125 120 130 120 120 130 120 120 126 060 125 120 120 120 
098 045 098 098 044 098 098 044 098 098 098 098 098 098 098 098 
098 044 098 098 044 098 098 044 098 098 098 098 098 098 098 098 
098 067 098 098 065 098 098 066 098 098 098 098 098 098 098 098 
020 028 020 020 029 020 020 029 020 026 058 058 025 018 098 098 
098 098 098 098 098 098 098 098 098 098 053 055 098 098 098 098 