098 098 098 098 098 098 046 098 046 098 098 098 098 098 044 098 
098 098 098 098 098 098 077 098 078 098 098 098 098 098 056 098 
024 033 025 020 020 020 029 020 029 026 058 025 021 098 044 098 
098 043 098 098 098 098 098 098 098 098 044 098 045 098 044 098 
098 043 098 098 098 098 098 098 098 098 044 098 044 098 046 098 
126 059 125 126 057 058 058 058 125 126 057 125 130 120 120 120 
098 043 098 098 040 040 040 040 098 098 046 098 054 052 051 098 
124 059 125 120 131 131 131 131 120 120 120 120 120 130 120 121 
045 098 098 098 098 098 098 098 098 098 098 098 098 098 098 098 
053 098 098 098 098 098 098 098 098 098 098 098 098 098 098 098 