056 098 098 098 098 098 098 098 098 098 098 098 098 098 098 098 
046 098 098 098 098 098 098 098 098 098 098 098 098 098 098 098 
020 026 058 025 026 058 025 026 058 058 058 058 058 025 021 098 
098 098 053 098 098 044 098 098 040 040 040 040 040 098 045 098 
047 047 049 122 120 130 120 120 131 131 131 131 131 120 130 121 
098 098 098 098 098 044 098 098 098 098 098 098 098 098 046 098 
098 098 022 020 020 030 020 021 098 124 058 058 058 125 120 121 
098 098 098 098 098 065 098 040 098 040 040 040 040 098 098 098 
098 098 098 098 022 028 020 029 020 031 031 031 031 018 098 098 
098 098 098 098 098 098 098 098 098 098 098 098 098 098 098 098 