098 044 098 098 098 098 098 098 098 098 098 046 098 098 098 098 
098 044 098 098 098 098 098 098 098 098 048 077 098 098 098 098 
098 056 098 098 098 098 098 124 058 058 125 129 126 063 033 123 
098 046 098 098 098 098 098 045 044 044 098 098 098 098 043 098 
020 020 020 026 058 025 020 030 030 030 020 020 020 026 059 025 
098 098 098 098 044 098 098 044 044 044 098 098 098 098 098 098 
098 098 098 098 044 098 098 046 046 046 098 098 098 098 098 098 
098 098 098 098 065 098 098 040 040 040 098 098 098 098 098 098 
098 098 098 022 028 020 020 029 029 029 026 058 025 018 098 098 
098 098 098 098 098 098 098 098 098 098 098 053 098 098 098 098 