056 098 098 098 098 098 098 098 098 098 098 098 098 098 098 098 
080 035 020 026 058 027 058 025 020 020 020 026 058 058 057 025 
098 098 098 098 044 098 044 098 098 070 098 098 040 040 040 098 
098 098 122 120 130 120 130 120 120 129 120 120 128 128 128 120 
098 098 045 098 044 098 044 098 098 098 098 098 098 098 098 098 
098 098 044 098 065 098 066 098 098 098 098 098 098 098 098 098 
020 026 058 025 029 020 029 020 020 020 026 057 025 020 020 020 
098 098 044 098 098 098 098 098 098 098 098 046 098 098 098 098 
020 026 058 025 020 026 058 025 020 020 020 020 020 018 098 098 
098 098 053 098 098 098 055 098 098 098 098 098 098 098 098 098 