056 098 098 098 098 098 098 098 098 098 098 098 098 098 098 098 
080 035 020 020 026 057 057 025 020 020 020 020 026 057 025 020 
098 098 098 098 098 046 044 098 098 098 098 098 098 046 098 098 
098 098 124 057 058 125 130 121 098 098 124 058 058 125 121 098 
098 098 098 040 040 098 044 098 098 098 040 040 040 098 098 098 
022 020 020 028 028 020 030 020 020 020 031 031 031 021 098 098 
098 098 098 098 098 098 048 035 058 058 023 098 098 045 098 098 
098 098 098 098 098 098 098 098 040 040 040 098 098 046 098 098 
098 098 118 126 058 058 125 120 131 131 131 120 120 120 121 098 
098 098 098 098 055 053 098 098 098 098 098 098 098 098 098 098 