056 098 098 098 098 098 098 098 098 098 098 098 098 098 098 098 
080 035 057 125 120 120 126 057 125 120 120 126 057 125 120 120 
098 098 065 098 098 098 098 066 098 098 098 098 044 098 098 098 
098 024 058 025 021 098 024 058 025 021 098 098 044 098 098 098 
098 098 044 098 040 098 098 044 098 040 098 098 067 098 098 098 
098 098 044 022 028 020 020 030 020 029 020 020 029 020 020 021 
098 098 048 035 020 020 021 048 035 020 020 021 098 098 098 045 
098 098 098 098 098 098 040 098 098 098 098 040 098 098 098 046 
098 098 118 120 120 120 129 120 120 120 120 129 120 120 120 120 
098 098 098 098 098 098 098 098 098 098 098 098 098 098 098 098 