033 025 020 020 020 020 026 058 058 058 023 098 098 098 044 098 
043 098 098 098 098 098 098 040 040 040 040 098 098 098 044 098 
043 098 122 120 120 120 120 128 128 128 128 121 098 098 044 098 
043 098 045 098 098 098 098 098 098 098 098 098 098 098 056 098 
043 098 044 098 078 098 098 098 098 098 098 098 098 098 044 098 
060 025 030 020 031 026 063 027 057 025 021 098 098 098 044 098 
043 098 046 098 098 098 098 098 044 098 045 098 098 098 044 098 
043 098 040 098 098 098 098 098 065 098 066 098 098 098 046 098 
059 125 131 126 058 127 058 125 131 120 131 120 120 120 120 120 
098 098 098 098 053 098 054 098 098 098 098 098 098 098 098 098 