056 098 098 098 098 098 098 098 098 098 098 098 098 098 098 098 
020 026 058 025 020 026 058 058 058 058 025 020 020 020 020 020 
098 098 044 098 098 098 040 040 040 040 098 098 098 098 098 098 
098 098 044 098 098 022 028 028 028 028 020 015 020 020 021 098 
098 098 046 098 098 098 098 098 098 098 098 098 098 098 045 098 
020 020 026 058 058 058 027 058 058 027 058 058 058 025 030 020 
098 098 098 040 040 040 040 040 040 040 040 040 040 098 046 098 
126 057 125 131 131 131 131 131 131 131 131 131 131 120 120 120 
098 048 035 020 020 020 026 058 027 058 025 020 020 018 098 098 
098 098 098 098 098 098 098 055 098 053 098 098 098 098 098 098 