098 098 098 098 098 098 098 098 098 098 098 098 098 098 098 098 
098 098 098 098 098 098 098 098 098 098 056 098 098 098 098 098 
098 098 098 098 098 098 098 098 098 098 046 098 098 098 098 098 
122 126 057 127 058 125 120 120 120 120 120 126 058 127 033 123 
045 098 044 098 040 098 098 098 098 098 098 098 040 098 043 098 
053 098 044 098 040 098 098 098 098 098 098 098 040 098 043 098 
049 098 046 098 040 098 098 098 077 098 098 098 040 098 043 098 
098 022 020 020 031 020 020 020 031 020 020 020 031 026 059 023 
098 098 098 098 098 098 098 098 098 098 098 098 098 098 098 045 
098 098 098 098 098 098 098 098 098 098 098 098 098 098 098 054 