056 098 098 098 098 098 098 098 098 098 098 098 098 098 098 098 
020 026 058 025 026 058 025 026 058 058 058 027 058 058 058 025 
098 098 044 098 098 065 098 098 040 040 040 098 044 044 044 098 
020 020 030 020 020 029 057 025 028 028 028 020 030 030 030 020 
098 098 040 098 098 098 098 098 098 098 098 098 040 040 040 098 
098 098 040 098 098 022 020 020 020 020 020 020 031 031 031 021 
098 098 040 098 124 058 125 126 058 033 061 033 125 120 120 120 
098 098 040 098 040 040 098 098 044 098 098 098 098 098 098 098 
020 020 028 020 031 031 020 026 058 058 025 020 020 018 098 098 
098 098 098 098 098 098 098 098 053 055 098 098 098 098 098 098 