098 056 098 098 098 098 098 098 098 098 024 033 025 020 021 098 
098 044 098 098 098 098 098 098 098 098 098 043 098 098 045 098 
098 046 098 098 098 098 098 098 098 098 098 043 098 098 065 098 
022 020 020 020 026 058 027 058 027 058 027 060 025 020 030 021 
098 098 098 098 098 044 098 044 098 044 098 052 047 047 049 045 
098 098 098 098 098 044 098 046 098 046 098 044 098 098 098 044 
098 098 098 098 098 066 098 040 098 040 098 046 098 098 098 053 
120 126 058 125 120 131 120 131 120 128 120 120 121 122 120 130 
098 098 055 098 098 098 098 098 098 098 098 098 098 045 098 044 
098 098 044 098 098 098 098 098 098 098 098 098 098 054 098 044 