124 058 058 058 127 058 127 058 036 035 033 127 033 123 056 098 
045 044 044 044 052 049 098 046 098 098 043 098 043 052 049 098 
130 049 044 044 048 051 022 020 020 026 059 051 043 044 052 047 
048 051 044 048 047 030 047 047 047 051 098 044 043 048 030 051 
052 130 049 098 098 048 047 051 098 044 098 044 043 098 044 046 
048 030 047 047 047 047 047 030 051 044 098 038 059 125 130 120 
047 049 098 122 126 033 123 044 044 044 052 130 047 047 049 052 
098 098 098 045 098 043 098 046 046 046 046 044 098 052 047 049 
098 098 098 054 098 043 098 040 040 040 040 053 098 055 098 098 
120 120 120 120 126 059 125 129 129 129 129 130 120 120 120 120 