044 098 098 122 126 033 098 033 025 026 058 058 057 025 021 098 
056 098 098 045 098 043 044 043 098 098 040 040 040 098 098 098 
044 098 098 044 098 043 044 043 098 022 028 028 028 020 021 098 
046 098 098 044 098 043 044 043 098 098 098 098 098 098 098 098 
026 033 025 030 026 060 027 060 027 058 058 058 057 025 021 098 
098 043 098 044 098 098 044 098 098 046 046 046 046 098 045 098 
098 043 098 065 098 098 070 098 098 040 040 040 040 098 044 098 
124 059 125 129 120 120 129 120 120 129 129 129 129 126 058 123 
045 098 098 098 098 098 098 098 098 098 098 098 098 098 044 098 
054 098 098 098 098 098 098 098 098 098 098 098 098 098 053 098 