098 098 056 098 098 098 098 098 098 098 098 098 098 098 098 098 
033 025 020 020 020 020 020 020 020 020 020 020 026 057 036 051 
043 122 120 120 057 120 120 057 120 057 120 120 126 057 123 044 
043 122 120 057 130 057 120 130 120 130 057 120 126 057 123 044 
043 122 120 130 130 130 057 130 057 130 130 057 120 120 121 044 
043 098 098 040 040 040 040 040 040 040 040 040 098 098 098 046 
043 098 022 031 031 031 031 031 031 031 031 031 020 020 020 021 
043 045 024 033 051 098 024 033 027 057 051 098 098 098 098 045 
043 053 098 043 054 098 098 043 098 040 065 098 077 098 098 046 
059 125 126 060 125 120 126 060 125 131 131 120 129 120 120 120 