098 056 098 098 098 098 098 034 034 034 098 098 098 098 098 098 
098 020 020 057 051 098 098 098 034 077 078 098 098 098 098 098 
098 098 054 054 054 098 098 029 033 029 021 098 045 098 098 098 
098 098 098 098 098 098 098 060 020 026 057 023 044 098 098 045 
098 098 098 098 098 063 055 043 098 022 026 079 050 098 098 037 
026 030 030 030 026 033 033 059 025 057 025 033 037 098 098 049 
098 048 080 049 098 098 098 098 098 046 098 098 046 098 098 098 
098 098 098 124 033 033 125 120 126 061 125 120 120 128 128 120 
098 098 118 120 120 098 098 098 098 098 098 098 098 098 098 098 
098 098 098 098 098 098 098 098 098 098 098 098 098 098 098 098 